border_size=1
usage=map

Ms          , Ms          , Ms          , Ms          , Ms          , Ms          , Ms          , Gg          , Ha          , Gg          , Hh          , Gs          , Gs          , Gs          , Gs          , Gs          , Gs          , Gs          , Gs          , Gs          , Gs          , Gs          , Gs          , Gs          , Gs          , Gs          , Gs          , Gs          , Gs          , Gs          , Gs          , Gs          , Gs          , Gs          , Gs          , Gs          , Gs          , Gs          
Ms          , Ms          , Ms          , Ms          , Ms          , Ms          , Ms          , Ha          , Ha          , Ha          , Hh          , Hh          , Hhd         , Gs          , Gs          , Gs^Vc       , Aa          , Gs          , Aa          , Gs          , Gs          , Gs          , Gs          , Gs^Vo       , Gs          , Gs          , Gs          , Gs          , Gs          , Gs          , Gs          , Aa          , Aa          , Aa          , Gs          , Gs          , Gs^Vc       , Gs          
Ms          , Ms          , Ms          , Ms          , Ms          , Ms          , Ha          , Ha          , Ha          , Ha          , Hh          , Hh          , Hhd^Fmw     , Hh^Fmw      , Gs          , Aa          , Aa          , Aa          , Aa          , Aa          , Aa          , Gs          , Gs          , Gs          , Gs          , Gd          , Gs          , Gs          , Aa          , Aa          , Aa^Voa      , Aa          , Gs          , Gs          , Gs          , Gs          , Gs          , Gs          
Ms          , Ms          , Ms          , Aa          , Aa          , Aa          , Ha          , Ha^Voa      , Ha          , Hh          , Hhd         , Hh          , Hh          , Hh          , Gs          , Gs          , Gs          , Gs          , Gs          , Gs          , Gs          , Aa          , Gs          , Gs          , Gs          , Gd          , Gd          , Aa          , Gs          , Aa          , Gs          , Aa          , Gs          , Gs          , Gs          , Gd          , Gd          , Gs          
Ms          , Ms          , Ms          , Ms          , Aa          , Aa          , Hh          , Ha          , Hh          , Hh          , Hh          , Hh          , Hh          , Hhd         , Gd          , Gs          , Gs          , Gs^Vo       , Gs          , Gs          , Gs          , Gs          , Gs          , Gs          , Gs          , Gs          , Gs          , Gs          , Gs          , Gs          , Gs          , Gs          , Hh          , Hh          , Gs          , Gs          , Gs          , Gd          
Ms          , Ms          , Ms          , Ms          , Hh          , Hh          , Hh          , Hh          , Hh          , Hhd         , Hh          , Hh          , Gs          , Gd          , Gs          , Hh          , Hh          , Gs          , Gs          , Gs          , Gs          , Gs          , Hh          , Gs          , Gs          , Gs          , Gs          , Gs          , Gs          , Gs          , Gs          , Hh          , Hh          , Hh          , Gs          , Gs          , Gs          , Gd          
Ms          , Ms          , Ms          , Aa          , Hh^Vo       , Hhd         , Hhd         , Hh^Fmw      , Hh          , Hh          , Hh          , Gs          , Gs          , Gs          , Hh          , Mm          , Gd          , Gs          , Gs          , Gs          , Hh          , Gs          , Gs          , Hh          , Gs          , Gs          , Gs          , Gs^Vo       , Gs          , Gs          , Hhd         , Gs          , Gs          , Hh          , Gs          , Gs          , Gs          , Gs          
Ms          , Ms          , Ms          , Hh          , Hh          , Hh          , Hhd^Fmw     , Hh^Fmw      , Hh          , Hh          , Gs          , Gs          , Gs          , Gs          , Gs          , Hhd         , Gd          , Gs          , Hhd^Vo      , Hh          , Hh          , Hh          , Co          , Hh          , Hh          , Gs          , Hh          , Gs          , Gs          , Gs          , Gs          , Gs          , Gs^Fmw      , Gs          , Gs          , Gs          , Gs^Vo       , Gs          
Ms          , Ms          , Ms          , Hhd         , Hh          , Hh^Fmw      , Hhd^Fmw     , Hh          , Hhd         , Hh          , Gs          , Gs^Vo       , Gs          , Gs          , Gs          , Gd          , Gd          , Hhd         , Hh          , Hh          , Co          , Co          , 3 Ko        , Co          , Mm          , Hh          , Gs          , Hh          , Hh          , Gs          , Gs          , Gs          , Gll^Fmw     , Gs^Fmw      , Gs          , Gs          , Gs          , Gs          
Ms          , Ms          , Ms          , Hhd         , Hh          , Hh          , Hh          , Hh          , Hh          , Hh          , Gs          , Gs          , Rd          , Gs          , Gs          , Gs          , Gs          , Hh          , Hh          , Gg          , Co          , Co          , Hh          , Co          , Co          , Hh          , Gs          , Gs          , Hh          , Gs          , Gs          , Gs          , Gs          , Gs          , Gs          , Gs          , Gs          , Gs          
Ms          , Ms          , Ms          , Hh          , Hh          , Hh          , Hh          , Hh          , Hh          , Hh          , Gs          , Gs          , Gs          , Gs          , Gs          , Gs          , Gs          , Gs          , Hh          , Hh          , Hh          , Ko          , Hh          , Hh          , Wwr         , Hh          , Hh          , Gs          , Hh          , Gs          , Gs          , Gs          , Gs          , Gg^Vo       , Gg          , Gs          , Gs          , Gs          
Ms          , Ms          , Ms          , Ms          , Hhd         , Hh^Vo       , Hh          , Hh          , Gs          , Gs          , Gs          , Gs          , Gs          , Rd          , Gg          , Gs          , Ww          , Ww          , Ww          , Hh          , Ww          , Wwr         , Wwr         , Ww          , Ww          , Ww          , Wwr         , Hh          , Ww          , Gg          , Ww          , Ww          , Ww          , Ww          , Ww          , Gs          , Gs          , Gs          
Ms          , Ms          , Ms          , Ms          , Hh          , Hhd         , Hh          , Hh          , Hh          , Gs          , Gs          , Gs          , Gs          , Gg          , Wwr         , Ww          , Ww          , Ww          , Ww          , Ww          , Ww          , Ww          , Gs          , Ww          , Gs          , Ww          , Ww          , Ww          , Ww          , Ww          , Ww          , Ww          , Gg          , Ww          , Ww          , Ww          , Wwr         , Wwr         
Ms          , Ms          , Ms          , Ms          , Aa          , Hhd         , Hh          , Hh          , Hh          , Hh          , Hh          , Gs          , Gg          , Ww          , Ww          , Ww          , Gs          , Gs          , Gs          , Gg          , Gs          , Gg          , Gs          , Gs          , Gs          , Gs          , Gg          , Gg          , Gs          , Ww          , Gg          , Gg          , Gs          , Gs          , Gs          , Gg          , Gs          , Ww          
Wo          , Ms          , Ms          , Ms          , Ai          , Aa          , Ai          , Hh          , Ww          , Hh          , Ww          , Hh          , Ww          , Ww          , Ww          , Gs          , Rd          , Gs          , Gd^Vc       , Gs          , Gs          , Gs          , Gs^Vo       , Gs          , Gs          , Gs          , Gs          , Gs          , Gs          , Gs          , Gs          , Gs          , Gs          , Gs          , Gs          , Gs          , Gs          , Gs          
Ms          , Wo          , Wo          , Wo          , Wo          , Ai          , Wo          , Ww          , Ww          , Ww          , Ww          , Ww          , Ww          , Ww          , Gs          , Gs          , Rd          , Gs          , Gs          , Gs          , Gs          , Gs          , Gs          , Gs          , Gs          , Rd          , Rd          , Gs          , Gs          , Gs          , Gs          , Gd          , Gd          , Gd          , Gs          , Gs          , Gs          , Gs          
Ms          , Ms          , Ms          , Ha          , Ha          , Wo          , Ha          , Ww          , Hh          , Ww          , Hh          , Hh          , Gs          , Gs          , Gs          , Gs          , Rd          , Gs          , Gs          , Gs          , Aa^Fma      , Aa          , Aa          , Gs          , Gs          , Gs          , Gs          , Rd          , Rd          , Gs          , Gs          , Gs          , Gs          , Gd^Vo       , Gs          , Gs          , Gs          , Gs          
Ms          , Ms          , Ha          , Aa          , Aa          , Ha          , Aa          , Hh          , Hh^Vc       , Hh          , Hh          , Hh          , Gs          , Gs          , Gs          , Gs          , Gs          , Gs          , Gs          , Aa^Fma      , Ha^Fma      , Ha^Fma      , Ha^Fma      , Aa^Fma      , Aa^Fma      , Gs          , Gs          , Gs          , Rd          , Gs          , Gs          , Gs          , Gs          , Gs          , Gll^Fmw     , Gll^Fmw     , Gs          , Gs          
Ms          , Ms          , Aa          , Aa          , Gs          , Aa          , Gs          , Hh          , Hh          , Hh          , Hhd         , Hh          , Gs          , Gs          , Gs          , Gs          , Gs          , Gs          , Gs          , Ha^Voa      , Ha^Fma      , Hh^Fmw      , Hh^Fmw      , Ha^Fma      , Gs^Fmw      , Gs          , Gs          , Gs          , Rd          , Gs          , Gs          , Gs          , Gs          , Gll^Fmw     , Ai          , Gll^Fmw     , Gs          , Gs          
Mm          , Ms          , Mm          , Gs          , Hhd         , Hh          , Hh          , Hh          , Hh          , Hh          , Hh          , Hh          , Gs          , Gs          , Gs          , Gs          , Gs          , Gs          , Aa          , Ha          , Gs          , Hh^Fmw      , Hhd^Fmw     , Hh^Fmw      , Hh          , Gs          , Gs          , Gs          , Gs          , Rd          , Gs          , Gs          , Gs          , Ai          , Ai          , Ai          , Ai          , Gs          
Mm          , Mm          , Mm          , Gd          , Gd          , Hh          , Hhd         , Hh^Fmw      , Hh^Vo       , Hh          , Hh          , Hh          , Gs          , Gs          , Gs          , Rd          , Rd          , Gs          , Gs          , Aa          , Gs          , Hh          , Gd          , Hhd         , Gs          , Gs          , Gd          , Gs          , Gs          , Rd          , Gd          , Gs          , Gs          , Ai          , Ai          , Ai          , Ai          , Ai          
Mm          , Mm          , Ms          , Mm^Vc       , Hhd         , Hhd         , Hh          , Hh^Fmw      , Hhd^Fmw     , Hh          , Hh          , Hh          , Gs          , Gs          , Gs          , Gs          , Gs          , Rd          , Rd          , Gs          , Gs          , Gs          , Gs          , Gs          , Rd          , Gs          , Gd          , Gs          , Gs          , Rd          , Gd          , Gs          , Gs          , Ww          , Ww          , Ai          , Ww          , Ww          
Ms          , Ms          , Aa          , Aa          , Gs          , Hh          , Hh          , Hh          , Hh          , Hhd         , Hh          , Gs          , Gs          , Gs          , Gs          , Gs^Fp       , Gs^Fp       , Gs          , Gs          , Gs          , Gs          , Gs          , Gs          , Rd          , Rd          , Gs          , Gs          , Gs          , Gs          , Rd          , Gs          , Gs          , Gs          , Gs          , Gs          , Ww          , Gs          , Gs          
Ai          , Ms          , Ww          , Aa          , Gg          , Hh          , Hh          , Hh          , Hh          , Hh          , Hh          , Gs          , Ww          , Gs          , Gs          , Gs          , Gs^Fp       , Gs          , Gs          , Gs          , Gs          , Gs          , Gs          , Gs          , Gs          , Gs          , Gs          , Gs          , Gs          , Rd          , Gs          , Gs          , Gs          , Gs          , Gs          , Gs          , Gd          , Gs          
Ai          , Ai          , Ww          , Ww          , Ww          , Ww          , Ww          , Ww          , Wwr         , Ww          , Ww          , Ww          , Ww          , Ww          , Wwr         , Gs          , Gs          , Gs          , Gs          , Gs          , Gs          , Gs^Vc       , Hh          , Hh          , Hh          , Ha          , Ha          , Gs          , Gs          , Rd          , Rd          , Gs          , Aa          , Gs          , Gs          , Gs          , Gs          , Gd          
Ms          , Ms          , Ms          , Ww          , Ha          , Ai          , Ww          , Ww          , Hh          , Ww          , Gg          , Ww          , Ww          , Ww          , Ww          , Gg          , Gg          , Gs          , Gs          , Rd          , Rd          , Gs          , Gs          , Gs          , Gs          , Hh          , Ha          , Ha          , Aa^Voa      , Aa          , Aa          , Aa          , Aa          , Gs          , Gs          , Gs          , Gs          , Gd          
Ms          , Ms          , Ms          , Ha          , Hh          , Hh          , Hh          , Hh          , Hh          , Hh          , Gs          , Gs          , Gs          , Gg          , Gs          , Ww          , Ww          , Gg          , Gs          , Gs          , Gs          , Gs          , Gs          , Gs          , Gs          , Gs          , Gs          , Aa          , Gs          , Aa          , Gd          , Rd          , Gd          , Aa          , Gs          , Gs          , Gs          , Gs          
Ms          , Ms          , Ms          , Hh          , Hh          , Hh          , Hh          , Hh^Vo       , Hh          , Hh          , Hh          , Gs          , Gs          , Gs          , Gs          , Gs          , Ww          , Ww          , Gs          , Gs          , Gs          , Gs          , Gs          , Gs          , Gs          , Gs          , Gs          , Gs          , Gs          , Gs          , Gd          , Rd          , Rd          , Gs          , Gs          , Gs          , Gs          , Gs          
Ms          , Ms          , Ms          , Hh          , Hh          , Hh          , Hh          , Hh          , Hhd         , Hh          , Hh          , Hh          , Hh          , Gs          , Gs          , Gs          , Gs          , Ai          , Ai          , Gs          , Gs          , Gs          , Gs          , Gs          , Gs          , Gs          , Gs          , Gs          , Gs          , Gs          , Gs          , Gs          , Gs          , Rd          , Rd          , Gs          , Rd          , Rd          
Ms          , Ms          , Ha          , Hh          , Hh          , Hh          , Hh          , Hh          , Hhd         , Hh          , Hh          , Hh          , Hh          , Gs          , Gs          , Gs          , Gs          , Gs          , Gs          , Ai          , Ww          , Gs          , Ww          , Gg          , Ww          , Gs          , Gg          , Gs          , Gs          , Gs          , Gs          , Gs          , Gg          , Gs          , Gs          , Rd          , Gs          , Gs          
Ms          , Ms          , Ha          , Ha          , Ha          , Ha          , Hh          , Hh          , Hh          , Hh          , Hh          , Hh          , Hh          , Gs          , Gs          , Gs          , Rd          , Rd          , Gs          , Gs          , Gs          , Ww          , Ww          , Ww          , Ww          , Ww          , Ww          , Ww          , Ww          , Gs          , Ww          , Ww          , Ww          , Ww          , Ww          , Gg          , Wwr         , Ww          
Ms          , Ms          , Ha          , Ha          , Ha          , Ha          , Hh          , Hhd         , Hh          , Hh          , Hh          , Chr         , Chr         , Gs          , Gs          , Gs          , Gs          , Gs          , Gs          , Gs          , Gs          , Gs          , Gs          , Ww          , Gg          , Ww          , Ww          , Ww          , Ww          , Wwf         , Ww          , Ww          , Chw         , Ww          , Chr         , Ww          , Ww          , Ww          
Ms          , Ms          , Hhd         , Hh          , Hh          , Hh          , Hh          , Hh          , Chr         , Chr         , Hh          , Hh          , Gs          , Gs          , Gs          , Rd          , Gs          , Gs          , Aa          , Gs          , Gs          , Gs          , Gs          , Gs          , Gs          , Gg          , Gs          , Ww          , Gs          , Gs          , Chr         , Chw         , 1 Khr       , Chr         , Gg          , Gg          , Chw         , Ww          
Ms          , Ms          , Hhd         , Hhd         , Mm          , Hh          , Chr         , Hh          , Chr         , Chr         , Chr         , Chr         , Gs          , Gs          , Gs          , Rd          , Gs          , Gs          , Gs          , Aa          , Aa          , Gs          , Aa          , Gs          , Gs          , Gs          , Gs          , Gs          , Gs          , Gs          , Gs          , Chr         , Gs          , Gs          , Gs          , Chr         , Gs          , Gg          
Ms          , Ms          , Ms          , Hhd         , Mm          , Hh          , Hhd         , Hh          , Hh          , 2 Khr       , Hh          , Gs          , Gs          , Gs          , Gs          , Rd          , Rd          , Gs          , Gs          , Gs          , Gs          , Aa          , Aa          , Aa          , Gs          , Gs          , Gs          , Gs          , Gs          , Gs          , Gs          , Gs          , Gs          , Gs          , Gs          , Gs          , Gs          , Gs          
Ms          , Ms          , Mm          , Mm          , Ha          , Mm          , Ha          , Hhd         , Hh          , Hh          , Gs          , Gs          , Gs          , Gs          , Gs          , Gs^Vo       , Rd          , Gs          , Gs          , Gs          , Gs          , Gs          , Gs          , Gs          , Gs          , Gs^Vc       , Gs          , Gs          , Gd          , Gs          , Gs          , Gs          , Gs          , Gs          , Gs          , Gs          , Ha          , Ha          
Ms          , Ms          , Ms          , Ms          , Ms          , Ha          , Ha          , Ha          , Hh          , Hh          , Gs          , Gs          , Gs          , Gs          , Gs          , Rd          , Gs          , Gs          , Gs          , Gs          , Gs          , Gs          , Gs          , Gs          , Gs          , Gs          , Gs          , Gs          , Gs          , Gd          , Gd          , Gd          , Aa          , Aa          , Aa          , Ha          , Ha          , Ha          
